#########################################################################################################
%                                                                                                       %
%                                                                                                       %
%                                                                                                       %
%                                                                                                       %
%                                                                                                       %
%                             !                                                                  !      %
%                                                                                                       %
%                                                                                                       %
%                                                                                                       %
%                                                                                                       %
%                                                                                                       %
%#######################################################################################################%
%#######################################################################################################%
%                                                                                                       %
%                                                                                                       %
%                                                                                                       %
%                                                                                                       %
%##########                                           **********                                        %
%                                                     **********                                        %
%###############        $$$$$$$$$$$$$$$$$$$$$$$$$$$$$$$$$$$$$$$$$$$$$$$$$$$$$$$$$$$$$$                  %
%                                                                                                       %
%                                                                                                       %
%                                                                                                       %
%                                                                                           ############%
%                                                                                           ############%
%                                                                                                       %
%                                                                                                       %
%                                                             *****************#########################%
%                                                             *****************#########################%
%      /\          ###########################################                                -------   %
%      \/          ###########################################                               |       |  %
%      /\                                                                                    |       |  %
#########################################################################################################