#########################################################################################################
%                                                                                                       %
%                                                                                                       %
%                                                                                                       %
%                                                                                                       %
%                                                                                                       %
%                             !                                                                  !      %
%                                                                                                       %
%                                                                                                       %
%                                                                                                       %
%                                                                                                       %
%                                                                                                       %
%#######################################################################################################%
%#######################################################################################################%
%                                                                                                       %
%                                                                                                       %
%                                                                                                       %
%                                                                                                       %
%##########                                           **********                                        %
%                                                     **********                                        %
%###############        $$$$$$$$$$$$$$$$$$$$$$$$$$$$$$$$$$$$$$$$$$$$$$$$$$$$$$$$$$$$$$                  %
%                                                                                                       %
%                                                                                                       %
%                                                                                                       %
%                                                                                           ############%
%                                                                                           ############%
%                                                                                                       %
%                          /\                                                                           %
%                          \/                                 *****************#########################%
%                          /\                                 *****************#########################%
%                  ###########################################                                -------   %
%                  ###########################################                               |       |  %
%                                                                                            |       |  %
#########################################################################################################