#########################################################################################################
%#                                                                                                      %
%#                                                                                                      %
%#                                                                                                      %
%#                                                                                                      %
%#                                                                                                      %
%#                             !                                                                  !     %
%#                                                                                                      %
%#                                                                                                      %
%#                                                                                                      % 
%#   ###################################################################################################%
%|__|###################################################################################################%
%|__|                                                                                                   %
%|__|                                                                                                   %     
%|__|                                                                                                   %
%|__|                                                                                                   %
%|  |        /\                                                                                         %
%##########  \/                      0                                                                  %
%            /\                     + +                     **********                                  %
%###################                + +                     **********                                  %
%                       $$$$$$$$$$$$$$$$$$$$$$$$$$$$$$$$$$$$$$$$$$$$$$$$$$$$$$$$$$$$$$$$                %                                                                %
%                                                                                                       %
%                                                                                                       %
%                                                                                           ############%
%                                                                                           ############%
%                                                                                                       %
%                                                                                                       %
%                                                             *****************#########################%
%                                                             *****************#########################%
%                  ###########################################                               (       )  %
%                  ######################################################################### (       )  %
%                                                                                            (       )  %
#########################################################################################################