#########################################################################################################
%                                                                                                       %
%                                                                                                       %
%                                                                                                       %
%                                                                                                       %
%                                                                                                       %
%                             !                                                                  !      %
%                                                                                                       %
%                                                                                                       %
%                                                                                                       %
%                                                                                                       %
%#######################################################################################################%
%#######################################################################################################%
% |__|                                                                                                  %     
% |  |                                                                                                  %
% |__|                                                                                                  %
% |  |                               0                                                                  %
%##########                         + +                     **********                                  %
%                                   + +                     **********                                  %
%###############        $$$$$$$$$$$$$$$$$$$$$$$$$$$$$$$$$$$$$$$$$$$$$$$$$$$$$$$$$$$$$$                  %
%                                                                                                       %
%                                                                                                       %
%                                                                                                       %
%                                                                                           ############%
%                                                                                           ############%
%                                                                                                       %
%                                                                                                       %
%                                                             *****************#########################%
%                                                             *****************#########################%
%      /\          ###########################################                                -------   %
%      \/          ###########################################                               |       |  %
%      /\                                                                                    |       |  %
#########################################################################################################